
############################################################
############################################################
#############a#####b####c############## 1###################
############# ##### #### ############## ####################
###3######### ##### #### ############## ####################
###                                                    #####
############################ ## ###################### #####
############################ ## ###################### 1####
############################2##d############################
############################################################
############################################################