############################################################
############################################################
############################1#####2################### H####
############################ ##### ################### #####
###A######################## ##### ################### #####
###                                                    #####
############################ ######################### #####
############################ ######################### H####
############################S###############################
############################################################
############################################################