############################################################
############################################################
############################################################
############################################################
############################################################
############################################################
############################################################
######################## 5###################     ##########
#######################2                            0#######
#3###################2## #######     ######## ##### ##0#####
#                        ####################7###       ####
############################################################
############################################################
############################################################
