############################################################
############################################ ###############
############################################ ###############
############################################ ###############
############################################ 8##############
############################################ ###############
#3 ##################                             ##########
######################## 5##################6   ############
#######################2                            0#######
#####################2## #######     ######## ##### ##0#####
#4 ###############       ####################7##         ###
############################################################
############################################################
############################################################
