############################################################
########################            ########################
################################### ########################
#3         ######################## 8#######################
### ###### ######################## ########################
### ###### #######                                  ########
### ###### ####2## ######1###### ######1##### ##### ###0####
#4                 ############# ############7#####      ###
################################ ###########################
################################G###########################
############################################################