############################################################
############################################################
############################################################
############################################################
############################################################
############################################################
#4                                            ##############
## ##################### 5##################6 ##############
## ####################2                            0#######
## ##################2## #######     ######## ##### ##0#####
#3                       ####################7#####      ###
#################################################        ###
############################################################
############################################################
